XXXXXXXXXXXXXXXXXXXXX
X   X X   X X X   X X
X XXX X XXX X XXX X X
X   X   X X   X   X  
XXX X XXX X XXXXX X X
X     X   X   X   X X
XXX X XXX X XXXXX X X
X X X   X X   X   X X
X XXXXX X X XXXXX X X
    X X         X   X
X XXX X XXXXXXX X XXX
X   X         X X   X
XXX XXX XXXXXXXXX XXX
X   X X X X X X     X
X XXX X X X X X X X X
X X X         X X X X
X X XXX XXX X X XXX X
X X X     X X     X X
X X X XXXXXXXXXXXXXXX
X                   X
XXXXXXXXXXXXXXXXXXXXX
